11 27 240 7
###########################
#/          !             #
#   &@@@@@@@@@@@@@@@@@    #
#                         #
#   @@ @@ @@ @@ @@ @@@    #  
#      +    @     +       #
#   @@  ##  !  @@   ##    #
#          ###            #
#        #######          D
#        &  !  &          #
###########################